                    R           1280             720
    F               0,0,   0
  NO              ./images/blue42.xpm
      SO    ./images/red42.xpm
                        WE ./images/light_green42.xpm
    EA ./images/yellow42.xpm


S                   ./images/poster42.xpm
C 255,255,255

         111111111111111111111
         112000000000000000021
      1111100000000S0000000001
      1000000000000000000000011111111
      1000000000111111000000000000001
      1000000001120001100000000000001
    11100000000111110100000000000011111
    10000000000000000000000000000000001
    10000000000000010000020000100000001
    12000000000000000000000000000000021
    11111111111111111111111111111111111