R 1280 720
NO ./images/blue42.xpm
SO ./images/red42.xpm
WE ./images/light_green42.xpm
EA ./images/yellow42.xpm

S ./images/poster42.xpm

C 0,0,0
F 255,255,255

 11111111111111111111
 12W00000000000000021
 10000111111111000001
 100001       1000001
 100001       1000001
 100001       1000001
 100001       1000001
 10000111111111000001
 12000000000000000021
 11111111111111111111