R 1 1
NO ./images/blue42.xpm
SO ./images/red42.xpm
WE ./images/light_green42.xpm
EA ./images/yellow42.xpm

S ./images/poster42.xpm

F 0,0,0
C 255,255,255

 11111111111111111111
 12000000000000000021
 10000111111111000001
 100001       10000011
 100001      11000001
 100001       10000011
 100001       10000011
 100001111111110000001
 120000000000000000211
 11111111111111111111